3 3 3 3 3 3 3 3 3 3
3 0 3 0 0 0 0 0 0 3
3 0 4 0 3 3 3 3 0 3
3 0 3 3 3 0 0 0 0 3
3 0 3 1 3 0 3 3 3 3
3 0 3 0 3 0 5 0 0 3
3 0 3 0 5 0 0 3 0 3
3 0 3 3 3 3 3 3 0 3
3 0 0 0 6 0 0 0 0 3
3 3 3 3 3 3 3 3 3 3
