3 3 3 3 3 3 3 3 3 3 3 3 3 3
3 0 0 0 3 0 0 0 0 3 0 0 0 3
3 0 3 3 0 0 3 3 0 0 0 3 0 3
3 0 0 3 0 3 1 0 3 0 3 0 0 3
3 3 0 3 0 0 3 7 3 6 3 0 3 3
3 0 0 3 0 0 0 0 3 5 3 0 0 3
3 0 3 0 0 3 3 4 3 4 3 3 0 3
3 0 3 3 4 3 3 5 3 6 3 0 0 3
3 0 0 0 0 0 3 0 3 0 3 0 0 3
3 3 3 3 3 3 3 3 3 3 3 3 3 3
