3 3 3 3 3 3 3 3 3 3
3 0 0 0 0 0 0 0 0 3
3 0 3 3 3 0 0 0 0 3
3 0 0 3 0 0 0 0 0 3
3 0 0 3 3 3 5 0 0 3
3 0 0 3 1 3 6 0 0 3
3 0 0 3 4 3 7 0 0 3
3 0 0 0 0 0 0 0 0 3
3 0 0 0 0 0 0 0 0 3
3 3 3 3 3 3 3 3 3 3